111122233
111122233
441225333
444425533
444555666
775586666
777588966
778889999
778889999